	  0,   0,   0,  20,   0,   0,   0,  16,   0,   0,   0,  20,   0,   0,   0,   0,
	  0,   0,   0,  21,  22,  23,   0,  18,   0,   0,   0,  21,  22,  23,   0,   0,
	  0,   0,   0,   0,   0,   0,   0,  18,   0,   0,   0,   0,   0,   0,   0,   0,
	  0,   0,   0,   0,  16,  16,  16,  18,  16,  16,  16,   0,   0,   0,   0,   0,
	  0,   0,   0,   0,  17,  17,  17,  18,  17,  17,  17,   0,   0,   0,   0,   0,
	  0,   0,   0,  20,   0,   0,   0,  18,   0,   0,   0,  20,   0,   0,   0,   0,
	  0,   0,   0,  21,  22,  23,   0,  18,   0,   0,   0,  21,  22,  23,   0,   0,
	  0,   0,   0,   0,   0,   0,   0,  17,   0,   0,   0,   0,   0,   0,   0,   0,
