	  0,   0,   0,  31,   0,   0,   0,  27,   0,   0,   0,  31,   0,   0,   0,   0,
	  0,   0,   0,  32,  33,  34,   0,  29,   0,   0,   0,  32,  33,  34,   0,   0,
	  0,   0,   0,   0,   0,   0,   0,  29,   0,   0,   0,   0,   0,   0,   0,   0,
	  0,   0,   0,   0,  27,  27,  27,  29,  27,  27,  27,   0,   0,   0,   0,   0,
	  0,   0,   0,   0,  28,  28,  28,  29,  28,  28,  28,   0,   0,   0,   0,   0,
	  0,   0,   0,  31,   0,   0,   0,  29,   0,   0,   0,  31,   0,   0,   0,   0,
	  0,   0,   0,  32,  33,  34,   0,  29,   0,   0,   0,  32,  33,  34,   0,   0,
	  0,   0,   0,   0,   0,   0,   0,  28,   0,   0,   0,   0,   0,   0,   0,   0,
